"","First_Name","Gender","2016_Total_Cnts","2015_Total_Cnts","Total"
"1","Emma","F",19414,20415,39829
"2","Olivia","F",19246,19638,38884
"3","Sophia","F",16070,17381,33451
"4","Ava","F",16237,16340,32577
"5","Isabella","F",14722,15574,30296
"6","Mia","F",14366,14871,29237
"7","Charlotte","F",13030,11381,24411
"8","Abigail","F",11699,12371,24070
"9","Emily","F",10926,11766,22692
"10","Harper","F",10733,10283,21016
